############################
        #########      #####
####                   #####
######  ############   #####
#              #####     ###
###########    ######      #
####        #########       
#########    ###########  ##
#######               ##  ##
############    ####      ##
############    #####     ##
              ####         #
#       ########        ####
#############        #######
####            ##      ####